100
30
48 51 51 51 51 51 51 51 51 51 51 51 51 51 51 51 51 51 51 51 51 51 51 51 51 51 51 51 51 51 51 51 51 51 51 51 51 51 51 51 51 51 51 48 48 48 48 48 51 51 51 51 51 51 51 51 51 51 51 51 51 51 51 51 51 51 51 51 51 51 51 51 51 51 51 51 51 51 51 48 51 51 51 51 51 51 51 51 51 51 51 51 51 51 51 51 51 51 51 48 
49 0 0 0 0 0 0 0 0 0 0 0 0 0 0 0 0 0 0 0 0 0 0 0 0 0 0 0 0 0 0 0 0 0 0 0 0 0 0 0 0 0 0 47 48 48 48 49 0 0 0 0 0 0 0 0 0 0 0 0 0 0 0 0 0 0 0 0 0 0 0 0 0 0 0 0 0 0 0 63 0 0 0 0 0 0 0 0 0 0 0 0 0 0 0 0 0 0 0 47 
49 0 0 0 0 0 0 0 0 0 0 0 0 0 0 0 0 0 0 0 0 0 0 0 0 0 0 0 0 0 0 0 0 0 0 0 0 0 0 0 0 0 0 47 48 48 48 49 0 0 0 0 0 0 0 0 0 0 0 0 0 0 0 0 0 0 0 0 0 0 0 0 0 0 0 0 0 0 0 63 0 0 0 0 0 0 0 0 0 0 0 0 0 0 0 0 0 0 0 47 
49 0 0 0 0 0 0 0 0 0 0 0 0 0 0 0 0 0 0 0 0 0 0 0 0 0 0 0 0 0 0 0 0 0 0 0 0 0 0 0 0 0 0 47 48 48 48 49 0 0 0 0 0 0 0 0 0 0 0 0 0 0 0 0 0 0 0 0 0 0 0 0 0 0 0 0 0 0 0 63 0 0 0 0 0 0 0 0 0 0 0 0 0 0 0 0 0 0 0 47 
49 0 0 0 0 0 0 0 0 0 0 0 0 0 0 0 0 0 0 0 0 0 0 0 0 0 0 0 0 0 0 0 0 0 0 0 0 0 0 0 0 0 0 47 48 48 48 49 0 0 0 0 0 0 0 0 0 0 0 0 0 0 0 0 0 0 0 0 0 0 0 0 0 0 0 0 0 0 0 63 0 0 0 0 0 0 0 0 0 0 0 0 0 0 0 0 0 0 0 47 
49 0 0 0 0 0 0 0 0 0 0 0 0 0 0 0 0 0 0 0 0 0 0 0 0 0 0 0 0 0 0 0 0 0 0 0 0 0 0 0 0 0 0 47 48 48 48 49 0 0 0 0 0 0 0 0 0 0 8 0 0 0 0 0 0 0 0 0 0 0 0 0 0 0 0 0 0 0 0 63 0 0 0 0 0 0 0 0 0 0 0 0 0 0 0 0 0 0 0 47 
49 0 0 0 0 0 0 0 0 0 0 0 0 0 0 0 0 0 0 0 0 0 0 0 0 0 0 0 0 0 0 0 0 0 0 0 0 0 0 0 0 0 0 47 48 48 48 49 0 0 0 0 44 0 0 0 5 0 7 0 0 0 0 0 0 0 0 0 0 0 0 0 44 46 0 0 0 0 0 63 0 0 0 0 44 46 0 0 5 0 0 0 4 0 0 5 0 0 0 47 
49 0 0 0 0 0 0 0 0 0 0 0 0 0 0 0 0 0 0 0 0 0 0 0 0 0 0 0 0 0 0 0 0 0 0 0 0 0 0 0 0 0 0 47 48 48 48 49 0 0 0 0 47 48 54 54 54 54 54 54 54 54 54 54 54 54 54 54 54 54 54 54 48 52 0 0 0 0 0 63 0 0 0 0 47 48 45 45 45 45 45 45 45 45 45 45 46 2 2 47 
49 0 0 0 0 0 0 0 0 0 0 0 0 0 0 0 0 0 0 0 0 0 0 0 0 0 0 0 0 0 0 0 0 0 0 0 0 0 0 0 0 0 0 47 48 48 48 49 0 0 0 0 63 0 0 0 0 0 0 0 0 0 0 0 0 0 0 0 0 0 0 0 0 0 0 0 0 0 0 63 0 0 0 0 47 48 48 48 48 48 48 48 48 48 48 48 49 2 2 47 
49 0 0 0 0 0 0 0 0 0 0 0 0 0 0 0 0 0 0 0 0 0 0 0 0 0 0 0 0 0 0 0 0 0 0 0 0 0 0 0 0 0 0 47 48 48 48 49 0 0 0 0 63 0 0 0 0 0 0 0 0 0 0 0 0 0 0 0 0 0 0 0 0 0 0 0 0 0 0 63 0 0 0 0 50 51 51 51 48 48 48 48 48 48 48 48 49 2 2 47 
49 0 0 0 0 0 0 0 0 0 0 0 0 0 0 0 0 0 0 0 0 0 0 0 0 0 0 0 0 0 0 0 0 0 0 0 0 0 0 0 0 0 0 47 48 48 48 49 0 0 0 0 63 0 0 0 0 0 0 0 0 0 0 0 0 0 0 0 0 0 0 0 0 0 0 0 0 0 0 63 0 0 0 0 0 0 0 0 0 48 48 48 48 48 48 48 49 2 2 47 
49 0 0 0 0 0 0 0 0 0 0 0 0 0 0 0 0 0 0 0 0 0 0 0 0 0 0 0 0 0 0 0 0 0 0 0 0 0 0 0 0 0 0 47 48 48 48 49 0 0 0 0 63 0 0 0 0 0 0 0 0 0 0 0 0 0 0 0 0 0 0 0 0 0 0 0 0 0 0 63 0 0 0 0 0 0 0 0 0 48 48 48 48 48 48 48 49 2 2 47 
49 0 0 0 0 0 0 0 0 0 0 0 0 0 0 0 0 0 0 0 0 0 0 0 0 0 0 0 0 0 0 0 0 0 0 0 0 0 0 0 0 0 0 47 48 48 48 49 0 0 0 0 63 0 0 0 0 0 0 0 0 0 0 0 0 0 0 0 0 0 0 0 0 0 0 0 0 0 0 63 0 0 0 0 0 0 0 0 0 48 48 48 48 48 48 48 49 2 2 47 
49 0 0 0 0 0 0 0 0 0 0 0 0 0 0 0 0 0 0 0 0 0 0 0 0 0 0 0 0 0 0 0 0 0 0 0 0 0 0 0 0 0 0 47 48 48 48 49 0 0 0 0 63 0 0 0 0 0 44 46 0 5 0 0 0 5 0 0 4 0 5 0 0 0 5 0 0 0 0 63 0 0 0 0 44 46 0 0 0 48 51 51 51 51 51 51 52 2 2 47 
49 0 0 0 0 0 0 0 0 0 0 0 0 0 0 0 0 0 0 0 0 0 0 0 0 0 0 0 0 0 0 0 0 0 0 0 0 0 0 0 0 0 0 47 48 48 48 49 0 0 0 0 63 0 0 0 0 0 51 48 54 54 54 54 54 54 54 54 54 54 54 54 54 54 54 45 45 45 45 49 0 0 0 0 47 49 0 0 0 49 2 2 2 2 2 2 2 2 2 47 
49 0 0 0 0 0 0 0 0 0 0 0 0 0 0 0 0 0 0 0 0 0 0 0 0 0 0 0 0 0 0 0 0 0 0 0 0 0 0 0 0 0 0 50 51 51 51 52 0 0 0 0 63 0 0 0 0 0 0 0 0 0 0 0 0 0 0 0 0 0 0 0 0 0 0 47 48 48 48 49 0 0 0 0 47 49 0 0 0 49 2 2 2 2 2 2 2 2 2 47 
49 0 0 0 0 0 0 0 0 0 0 0 0 0 0 0 0 0 0 0 0 0 0 0 0 0 0 0 0 0 0 0 0 0 0 0 0 0 0 0 0 0 0 9 10 10 10 11 0 0 0 0 63 0 0 0 0 0 0 0 0 0 0 0 0 0 0 0 0 0 0 0 0 0 0 47 48 48 48 49 0 0 0 0 47 49 0 0 0 49 2 2 2 2 53 45 45 45 45 48 
49 0 0 0 0 0 0 0 0 0 0 0 0 0 0 0 0 0 0 0 0 0 0 0 0 0 0 0 0 0 0 0 0 0 0 0 0 0 0 0 0 0 0 9 10 10 10 11 0 0 0 0 63 0 0 0 0 0 0 0 0 0 0 0 0 0 0 0 0 0 0 0 0 0 0 47 48 48 48 49 0 0 0 0 47 49 0 0 0 49 2 2 2 2 2 2 2 2 2 47 
49 0 0 0 0 0 0 0 0 0 0 0 0 0 0 0 0 0 0 0 0 0 0 0 0 0 0 0 0 0 0 0 0 0 0 0 0 0 0 0 0 0 0 9 10 10 10 11 0 0 0 0 63 0 0 0 0 0 0 0 0 0 0 0 0 0 0 0 0 0 0 0 0 0 0 47 48 48 48 49 0 0 0 0 47 49 0 4 0 49 2 2 2 2 2 2 2 2 2 47 
49 0 0 0 0 0 0 0 0 0 0 0 0 0 0 0 0 0 0 0 0 0 0 0 0 0 0 0 0 0 0 0 0 0 0 0 0 0 0 0 0 0 0 9 10 10 10 11 0 0 0 0 63 0 0 0 0 0 0 0 0 0 0 0 0 0 0 0 0 0 0 0 0 0 0 47 48 48 48 49 0 0 0 0 47 48 45 45 48 49 2 2 2 2 2 2 2 2 2 47 
49 0 0 0 0 0 0 0 0 0 0 0 0 0 0 0 0 0 0 0 0 0 0 0 0 0 0 0 0 0 0 0 0 0 0 0 0 0 0 0 0 0 0 9 10 10 10 11 0 0 0 0 63 0 0 8 0 0 0 0 0 0 0 0 0 0 0 0 0 0 0 0 0 0 0 47 48 48 48 49 0 0 0 0 0 0 47 48 48 49 2 2 2 2 2 2 2 2 2 47 
49 0 0 0 0 0 0 0 0 0 0 0 0 0 0 0 0 0 0 0 0 0 0 0 0 0 0 0 0 0 0 0 0 0 0 0 0 0 0 0 0 0 0 20 10 27 10 22 0 0 0 0 63 0 0 7 4 0 0 0 0 0 0 0 0 0 0 0 0 0 0 0 0 0 0 47 48 48 48 49 8 0 0 0 0 0 47 48 48 49 2 2 2 2 2 2 2 2 2 47 
49 0 0 0 0 0 0 0 0 0 0 0 0 0 0 0 0 0 0 0 0 0 0 0 0 0 0 0 0 0 0 0 0 0 0 0 0 0 0 0 0 0 0 44 45 45 45 46 0 0 0 0 47 45 45 45 45 46 0 0 0 0 0 0 0 0 0 0 5 4 0 0 0 0 0 47 48 48 48 49 7 0 0 0 0 0 47 48 48 49 2 2 2 2 2 2 2 2 2 47 
49 0 0 0 0 0 0 0 0 0 0 0 0 0 0 0 0 0 0 0 0 0 0 0 0 0 0 0 0 0 0 0 0 0 0 0 0 0 0 0 0 13 44 48 48 48 48 49 0 0 0 0 47 48 48 48 48 48 46 4 0 0 0 0 0 0 0 0 44 45 46 0 0 0 0 50 51 51 51 51 54 45 0 0 0 0 47 48 48 49 2 2 2 2 2 2 2 2 2 47 
49 0 0 8 0 0 0 0 0 0 0 0 0 0 0 0 0 0 0 0 8 0 0 0 0 0 0 0 0 0 0 0 0 0 0 0 0 0 0 0 0 44 48 48 48 48 48 49 0 0 0 0 47 48 48 48 48 48 48 46 0 0 0 0 0 0 0 0 47 48 49 0 0 0 0 0 0 0 0 0 0 0 0 0 0 5 47 48 48 49 2 2 2 2 2 2 2 2 2 47 
49 0 4 7 0 5 0 0 6 0 0 0 6 0 0 0 4 0 0 6 7 0 44 46 0 0 0 0 44 46 15 0 6 0 13 0 12 0 16 0 44 48 48 48 48 48 48 49 0 0 0 0 47 48 48 48 48 48 48 48 46 0 0 0 5 4 0 0 47 48 49 0 0 0 0 0 0 0 0 0 0 0 0 4 44 45 48 48 48 48 45 45 45 45 45 45 45 45 45 48 
48 45 45 45 45 45 45 45 45 45 45 45 45 45 45 45 45 45 45 45 45 45 48 49 0 0 0 0 47 48 45 45 45 45 45 45 45 45 45 45 48 48 48 48 48 48 48 49 0 0 0 0 47 48 48 48 48 48 48 48 48 45 45 45 45 45 45 45 48 48 49 0 0 0 0 0 0 0 0 0 0 0 0 44 48 48 48 48 48 48 48 48 48 48 48 48 48 48 48 48 
48 48 48 48 48 48 48 48 48 48 48 48 48 48 48 48 48 48 48 48 48 48 48 49 0 0 0 0 47 48 48 48 48 48 48 48 48 48 48 48 48 48 48 48 48 48 48 49 0 0 0 0 47 48 48 48 48 48 48 48 48 48 48 48 48 48 48 48 48 48 49 0 0 0 0 0 5 0 0 4 0 0 44 48 48 48 48 48 48 48 48 48 48 48 48 48 48 48 48 48 
48 48 48 48 48 48 48 48 48 48 48 48 48 48 48 48 48 48 48 48 48 48 48 49 0 0 0 0 47 48 48 48 48 48 48 48 48 48 48 48 48 48 48 48 48 48 48 49 0 0 0 0 47 48 48 48 48 48 48 48 48 48 48 48 48 48 48 48 48 48 49 0 0 0 0 44 45 45 45 45 45 45 48 48 48 48 48 48 48 48 48 48 48 48 48 48 48 48 48 48 
48 48 48 48 48 48 48 48 48 48 48 48 48 48 48 48 48 48 48 48 48 48 48 48 45 45 45 45 48 48 48 48 48 48 48 48 48 48 48 48 48 48 48 48 48 48 48 48 45 45 45 45 48 48 48 48 48 48 48 48 48 48 48 48 48 48 48 48 48 48 48 45 45 45 45 48 48 48 48 48 48 48 48 48 48 48 48 48 48 48 48 48 48 48 48 48 48 48 48 48 
